border_size=1
usage=map

Qxu         , Qxu         , Qxu         , Qxu         , Qxu         , Qxu         , Qxu         , Qxu         , Qxu         , Qxu         , Qxu         , Qxu         , Qxu         , Qxu         , Qxu         , Qxu         , Qxu         , Qxu         , Qxu         , Qxu         , Xu          , Xu          , Xu          , Qxu         , Qxu         , Qxu         , Qxu         , Qxu         , Qxu         , Qxu         , Qxu         , Qxu         , Qxu         , Qxu         , Qxu         , Qxu         , Qxu         , Qxu         , Qxu         , Qxu         , Qxu         , Qxu         , Qxu         
Qxu         , Uu^Vud      , Qxu^Bs\     , Qxu         , Qxu         , Qxu         , Qxu         , Qxu         , Qxu         , Qxu         , Uu          , Qxu         , Rr          , Qxu         , Uu          , Qxu         , Qxu         , Qxu         , Qxu         , Qxu         , Ww          , Xu          , Ww          , Qxu         , Qxu         , Qxu         , Qxu         , Qxu         , Uu          , Qxu         , Rr          , Qxu         , Uu          , Qxu         , Qxu         , Qxu         , Qxu         , Qxu         , Qxu         , Qxu         , Qxu^Bs/     , Uu^Vud      , Qxu         
Qxu         , Qxu         , Qxu         , Re          , Qxu^Bs\     , Qxu         , Ww          , Qxu         , Qxu         , Qxu         , Qxu         , Rr          , Ur          , Rr          , Qxu         , Qxu         , Qxu         , Qxu         , Ww          , Qxu         , Ww          , Ww          , Ww          , Qxu         , Ww          , Qxu         , Qxu         , Qxu         , Qxu         , Rr          , Ur          , Rr          , Qxu         , Qxu         , Qxu         , Qxu         , Ww          , Qxu         , Qxu^Bs/     , Re          , Qxu         , Qxu         , Qxu         
Qxu         , Qxu         , Qxu         , Qxu         , Qxu         , Ww          , Ww          , Ww          , Ww          , Qxu         , Uu          , Rr          , Rr          , Rr          , Uu          , Qxu         , Ww          , Ww          , Ww          , Ww          , Ww          , Ww          , Ww          , Ww          , Ww          , Ww          , Ww          , Qxu         , Uu          , Rr          , Rr          , Rr          , Uu          , Qxu         , Ww          , Ww          , Ww          , Ww          , Qxu         , Qxu         , Qxu         , Qxu         , Qxu         
Qxu         , Qxu         , Xu          , Qxu         , Ww          , Ww          , Wwr         , Ww          , Ww          , Qxu         , Qxu         , Qxu         , Wwf         , Qxu         , Qxu         , Qxu         , Ww          , Ww          , Gs^Fp       , Ww          , Ww          , Ww          , Ww          , Ww          , Gs^Fp       , Ww          , Ww          , Qxu         , Qxu         , Qxu         , Wwf         , Qxu         , Qxu         , Qxu         , Ww          , Ww          , Wwr         , Ww          , Ww          , Qxu         , Xu          , Qxu         , Qxu         
Qxu         , Qxu         , Qxu         , Qxu         , Ww          , Ww          , Gg          , Ww          , Ww          , Ww          , Wwf         , Wwf         , Ww^Vm       , Ww          , Ww          , Ww          , Ww          , Ww          , Hh^Fp       , Gg          , Gg          , Gg          , Gg          , Gg          , Hh^Fp       , Ww          , Ww          , Ww          , Ww          , Ww          , Ww^Vm       , Wwf         , Wwf         , Ww          , Ww          , Ww          , Gg          , Ww          , Ww          , Qxu         , Qxu         , Qxu         , Qxu         
Qxu         , Qxu         , Qxu         , Ww          , Ww          , Ww          , Ww          , Hh          , Hh^Vhh      , Wwf         , Ww          , Ww          , Ww          , Ww          , Ww          , Ww          , Gs^Fp       , Hh^Fp       , Hh^Vhh      , Hh^Fp       , Gg          , Gg          , Gg          , Hh^Fp       , Hh^Vhh      , Hh^Fp       , Gs^Fp       , Ww          , Ww          , Ww          , Ww          , Ww          , Ww          , Wwf         , Hh^Vhh      , Hh          , Ww          , Ww          , Ww          , Ww          , Qxu         , Qxu         , Qxu         
Qxu         , Qxu         , Qxu         , Ww          , Ww          , Ww          , Wwr         , Wwr         , Mm          , Hh          , Ds          , Ww          , Ds          , Ww          , Ds          , Gg          , Gs^Fp       , Hh^Fp       , Hh^Fp       , Hh^Fp       , Gg          , Gg          , Gg          , Hh^Fp       , Hh^Fp       , Hh^Fp       , Gs^Fp       , Gg          , Ds          , Ww          , Ds          , Ww          , Ds          , Hh          , Mm          , Wwr         , Wwr         , Ww          , Ww          , Ww          , Qxu         , Qxu         , Qxu         
Qxu         , Ur          , Qxu         , Ww          , Ww          , Ww          , Mm          , Hh^Fp       , Hh^Fp       , Hh          , Hh          , Ds          , Gg          , Ds          , Gg          , Gg          , Gg          , Gs^Fp       , Gg          , Gs^Fp       , Gg          , Gg          , Gg          , Gs^Fp       , Gg          , Gs^Fp       , Gg          , Gg          , Gg          , Ds          , Gg          , Ds          , Hh          , Hh          , Hh^Fp       , Hh^Fp       , Mm          , Ww          , Ww          , Ww          , Qxu         , Ur          , Qxu         
Qxu         , Qxu         , Qxu         , Qxu         , Ww          , Ww          , Wwr         , Ch          , Ch          , Mm          , Rr          , Gg          , Gg          , Gg          , Gg          , Gg          , Ql          , Gg          , Gg          , Gg          , Gg          , Gg          , Gg          , Gg          , Gg          , Gg          , Ql          , Gg          , Gg          , Gg          , Gg          , Gg          , Rr          , Mm          , Ch          , Ch          , Wwr         , Ww          , Ww          , Qxu         , Qxu         , Qxu         , Qxu         
Qxu         , Ur          , Qxu         , Ww          , Ww          , Ww          , Chw         , Ch          , Rr          , Ch          , Hh          , Hh          , Hh          , Hh          , Gg          , Gg          , Ql          , Ql          , Ql^Bs/      , Gg          , Ql          , Ql          , Ql          , Gg          , Ql^Bs\      , Ql          , Ql          , Gg          , Gg          , Hh          , Hh          , Hh          , Hh          , Ch          , Rr          , Ch          , Chw         , Ww          , Ww          , Ww          , Qxu         , Ur          , Qxu         
Qxu         , Qxu         , Qxu         , Ww          , Ww          , Mm^Vhh      , Chw         , 1 Kh        , Rr          , Rr          , Hh          , Hh          , Hh          , Gg^Vh       , Gg          , Ql          , Ql          , Re          , Ql^Bs\      , Ql          , Ql          , Qlf         , Ql          , Ql          , Ql^Bs/      , Re          , Ql          , Ql          , Gg          , Gg^Vh       , Hh          , Hh          , Hh          , Rr          , Rr          , 2 Kh        , Chw         , Mm^Vhh      , Ww          , Ww          , Qxu         , Qxu         , Qxu         
Qxu         , Ur          , Qxu         , Ww          , Ww          , Ww          , Wwr         , Ch          , Ch          , Ch          , Rr          , Hh          , Gg          , Hh          , Gg          , Gg          , Ql          , Ql          , Gg          , Gg          , Gg          , Ql          , Gg          , Gg          , Gg          , Ql          , Ql          , Gg          , Gg          , Hh          , Gg          , Hh          , Rr          , Ch          , Ch          , Ch          , Wwr         , Ww          , Ww          , Ww          , Qxu         , Ur          , Qxu         
Qxu         , Qxu         , Qxu         , Qxu         , Ww          , Ww          , Mm          , Ch          , Hh^Fp       , Mm          , Hh          , Gg          , Gg          , Gg          , Gg          , Gg          , Gg          , Gg          , Gg          , Gg          , Gg          , Gg          , Gg          , Gg          , Gg          , Gg          , Gg          , Gg          , Gg          , Gg          , Gg          , Gg          , Hh          , Mm          , Hh^Fp       , Ch          , Mm          , Ww          , Ww          , Qxu         , Qxu         , Qxu         , Qxu         
Qxu         , Ur          , Qxu         , Ww          , Ww          , Ww          , Wwr         , Hh^Fp       , Mm          , Hh          , Ds          , Ds          , Ds          , Ds          , Ds          , Gg          , Gs^Fp       , Gs^Fp       , Hh^Fp       , Gs^Fp       , Gg          , Gg          , Gg          , Gs^Fp       , Hh^Fp       , Gs^Fp       , Gs^Fp       , Gg          , Ds          , Ds          , Ds          , Ds          , Ds          , Hh          , Mm          , Hh^Fp       , Wwr         , Ww          , Ww          , Ww          , Qxu         , Ur          , Qxu         
Qxu         , Qxu         , Qxu         , Ww          , Ww          , Ww          , Ww          , Wwr         , Hh^Vhh      , Hh          , Ww          , Ww          , Ww          , Ww          , Ww          , Gg          , Gs^Fp       , Hh^Fp       , Hh^Vhh      , Hh^Fp       , Gg          , Gg          , Gg          , Hh^Fp       , Hh^Vhh      , Hh^Fp       , Gs^Fp       , Gg          , Ww          , Ww          , Ww          , Ww          , Ww          , Hh          , Hh^Vhh      , Wwr         , Ww          , Ww          , Ww          , Ww          , Qxu         , Qxu         , Qxu         
Qxu         , Qxu         , Qxu         , Ww          , Ww          , Ww          , Gg          , Hh          , Ww          , Wwf         , Wwf         , Ww          , Ww^Vm       , Ww          , Ww          , Ww          , Ww          , Hh^Fp       , Hh^Fp       , Hh^Fp       , Gg          , Gg          , Gg          , Hh^Fp       , Hh^Fp       , Hh^Fp       , Ww          , Ww          , Ww          , Ww          , Ww^Vm       , Ww          , Wwf         , Wwf         , Ww          , Hh          , Gg          , Ww          , Ww          , Ww          , Qxu         , Qxu         , Qxu         
Qxu         , Qxu         , Xu          , Qxu         , Ww          , Ww          , Wwr         , Ww          , Ww          , Ww          , Qxu         , Wwf         , Wwf         , Ww          , Qxu         , Ww          , Ww          , Ww          , Gs^Fp       , Gg          , Ww          , Gg          , Ww          , Gg          , Gs^Fp       , Ww          , Ww          , Ww          , Qxu         , Ww          , Wwf         , Wwf         , Qxu         , Ww          , Ww          , Ww          , Wwr         , Ww          , Ww          , Qxu         , Xu          , Qxu         , Qxu         
Qxu         , Qxu         , Qxu         , Qxu         , Qxu         , Ww          , Ww          , Ww          , Ww          , Qxu         , Uu          , Qxu         , Rr          , Qxu         , Uu          , Qxu         , Ww          , Ww          , Ww          , Ww          , Ww          , Ww          , Ww          , Ww          , Ww          , Ww          , Ww          , Qxu         , Uu          , Qxu         , Rr          , Qxu         , Uu          , Qxu         , Ww          , Ww          , Ww          , Ww          , Qxu         , Qxu         , Qxu         , Qxu         , Qxu         
Qxu         , Qxu         , Qxu         , Qxu         , Qxu^Bs/     , Ww          , Ww          , Ww          , Qxu         , Qxu         , Qxu         , Rr          , Ur          , Rr          , Qxu         , Qxu         , Qxu         , Ww          , Ww          , Ww          , Ww          , Ww          , Ww          , Ww          , Ww          , Ww          , Qxu         , Qxu         , Qxu         , Rr          , Ur          , Rr          , Qxu         , Qxu         , Qxu         , Ww          , Ww          , Ww          , Qxu^Bs\     , Qxu         , Qxu         , Qxu         , Qxu         
Qxu         , Qxu         , Qxu^Bs/     , Re          , Qxu         , Qxu         , Qxu         , Qxu         , Qxu         , Qxu         , Uu          , Rr          , Rr          , Rr          , Uu          , Qxu         , Qxu         , Qxu         , Qxu         , Qxu         , Ww          , Ww          , Ww          , Qxu         , Qxu         , Qxu         , Qxu         , Qxu         , Uu          , Rr          , Rr          , Rr          , Uu          , Qxu         , Qxu         , Qxu         , Qxu         , Qxu         , Qxu         , Re          , Qxu^Bs\     , Qxu         , Qxu         
Qxu         , Uu^Vud      , Qxu         , Qxu         , Qxu         , Qxu         , Qxu         , Qxu         , Qxu         , Qxu         , Qxu         , Qxu         , Qxu         , Qxu         , Qxu         , Qxu         , Qxu         , Qxu         , Qxu         , Qxu         , Xu          , Xu          , Xu          , Qxu         , Qxu         , Qxu         , Qxu         , Qxu         , Qxu         , Qxu         , Qxu         , Qxu         , Qxu         , Qxu         , Qxu         , Qxu         , Qxu         , Qxu         , Qxu         , Qxu         , Qxu         , Uu^Vud      , Qxu         
Qxu         , Qxu         , Qxu         , Qxu         , Qxu         , Qxu         , Qxu         , Qxu         , Qxu         , Qxu         , Qxu         , Qxu         , Qxu         , Qxu         , Qxu         , Qxu         , Qxu         , Qxu         , Qxu         , Qxu         , Xu          , Xu          , Xu          , Qxu         , Qxu         , Qxu         , Qxu         , Qxu         , Qxu         , Qxu         , Qxu         , Qxu         , Qxu         , Qxu         , Qxu         , Qxu         , Qxu         , Qxu         , Qxu         , Qxu         , Qxu         , Qxu         , Qxu         
